"filename", "language", "JavaScript", "JSON", "comment", "blank", "total"
"c:\Users\Ljubo\Documents\GitHub\ecommerce\frontend\package-lock.json", "JSON", 0, 135, 0, 0, 135
"c:\Users\Ljubo\Documents\GitHub\ecommerce\frontend\package.json", "JSON", 0, 1, 0, 0, 1
"c:\Users\Ljubo\Documents\GitHub\ecommerce\frontend\src\App.js", "JavaScript", 20, 0, -11, 2, 11
"c:\Users\Ljubo\Documents\GitHub\ecommerce\frontend\src\app\features\User\inboxMessages.js", "JavaScript", 17, 0, 0, 5, 22
"c:\Users\Ljubo\Documents\GitHub\ecommerce\frontend\src\app\features\triggeri.js", "JavaScript", 17, 0, 0, 5, 22
"c:\Users\Ljubo\Documents\GitHub\ecommerce\frontend\src\app\store.js", "JavaScript", 4, 0, 0, -1, 3
"c:\Users\Ljubo\Documents\GitHub\ecommerce\frontend\src\components\Navbar\Navbar.js", "JavaScript", 16, 0, 0, 0, 16
"c:\Users\Ljubo\Documents\GitHub\ecommerce\frontend\src\components\Navbar\NavbarUserMenu.js", "JavaScript", -114, 0, 0, -5, -119
"c:\Users\Ljubo\Documents\GitHub\ecommerce\frontend\src\components\Register\RegisterPage.js", "JavaScript", -46, 0, 0, -5, -51
"c:\Users\Ljubo\Documents\GitHub\ecommerce\frontend\src\components\User\Inbox\Chat.js", "JavaScript", 40, 0, 1, 1, 42
"c:\Users\Ljubo\Documents\GitHub\ecommerce\frontend\src\components\User\Inbox\Inbox.js", "JavaScript", 49, 0, 1, 6, 56
"Total", "-", 3, 136, -9, 8, 138