"filename", "language", "JavaScript", "JSON", "Properties", "comment", "blank", "total"
"c:\Users\Ljubo\Documents\GitHub\ecommerce\backend\.env", "Properties", 0, 0, 3, 0, 0, 3
"c:\Users\Ljubo\Documents\GitHub\ecommerce\backend\Controllers\auth.js", "JavaScript", 62, 0, 0, 0, 10, 72
"c:\Users\Ljubo\Documents\GitHub\ecommerce\backend\Controllers\customer.js", "JavaScript", 453, 0, 0, 97, 123, 673
"c:\Users\Ljubo\Documents\GitHub\ecommerce\backend\Controllers\store.js", "JavaScript", 394, 0, 0, 9, 119, 522
"c:\Users\Ljubo\Documents\GitHub\ecommerce\backend\Controllers\user.js", "JavaScript", 69, 0, 0, 0, 27, 96
"c:\Users\Ljubo\Documents\GitHub\ecommerce\backend\Models\addToCart.js", "JavaScript", 6, 0, 0, 0, 4, 10
"c:\Users\Ljubo\Documents\GitHub\ecommerce\backend\Models\chat.js", "JavaScript", 7, 0, 0, 0, 4, 11
"c:\Users\Ljubo\Documents\GitHub\ecommerce\backend\Models\post.js", "JavaScript", 19, 0, 0, 0, 5, 24
"c:\Users\Ljubo\Documents\GitHub\ecommerce\backend\Models\product.js", "JavaScript", 17, 0, 0, 0, 5, 22
"c:\Users\Ljubo\Documents\GitHub\ecommerce\backend\Models\review.js", "JavaScript", 10, 0, 0, 0, 4, 14
"c:\Users\Ljubo\Documents\GitHub\ecommerce\backend\Models\sale.js", "JavaScript", 14, 0, 0, 0, 4, 18
"c:\Users\Ljubo\Documents\GitHub\ecommerce\backend\Models\store.js", "JavaScript", 13, 0, 0, 0, 4, 17
"c:\Users\Ljubo\Documents\GitHub\ecommerce\backend\Models\user.js", "JavaScript", 31, 0, 0, 0, 4, 35
"c:\Users\Ljubo\Documents\GitHub\ecommerce\backend\Routes\auth.js", "JavaScript", 7, 0, 0, 0, 6, 13
"c:\Users\Ljubo\Documents\GitHub\ecommerce\backend\Routes\customer.js", "JavaScript", 65, 0, 0, 0, 4, 69
"c:\Users\Ljubo\Documents\GitHub\ecommerce\backend\Routes\store.js", "JavaScript", 68, 0, 0, 2, 27, 97
"c:\Users\Ljubo\Documents\GitHub\ecommerce\backend\Routes\user.js", "JavaScript", 15, 0, 0, 1, 9, 25
"c:\Users\Ljubo\Documents\GitHub\ecommerce\backend\index.js", "JavaScript", 60, 0, 0, 1, 10, 71
"c:\Users\Ljubo\Documents\GitHub\ecommerce\backend\package-lock.json", "JSON", 0, 7053, 0, 0, 1, 7054
"c:\Users\Ljubo\Documents\GitHub\ecommerce\backend\package.json", "JSON", 0, 28, 0, 0, 1, 29
"Total", "-", 1310, 7081, 3, 110, 371, 8875