"filename", "language", "JavaScript", "JSON", "Properties", "comment", "blank", "total"
"c:\Users\Ljubo\Documents\GitHub\ecommerce\backend\.env", "Properties", 0, 0, 3, 0, 0, 3
"c:\Users\Ljubo\Documents\GitHub\ecommerce\backend\Controllers\auth.js", "JavaScript", 83, 0, 0, 0, 10, 93
"c:\Users\Ljubo\Documents\GitHub\ecommerce\backend\Controllers\customer.js", "JavaScript", 265, 0, 0, 28, 84, 377
"c:\Users\Ljubo\Documents\GitHub\ecommerce\backend\Controllers\store.js", "JavaScript", 278, 0, 0, 9, 85, 372
"c:\Users\Ljubo\Documents\GitHub\ecommerce\backend\Controllers\user.js", "JavaScript", 69, 0, 0, 0, 27, 96
"c:\Users\Ljubo\Documents\GitHub\ecommerce\backend\Models\addToCart.js", "JavaScript", 6, 0, 0, 0, 4, 10
"c:\Users\Ljubo\Documents\GitHub\ecommerce\backend\Models\product.js", "JavaScript", 17, 0, 0, 0, 5, 22
"c:\Users\Ljubo\Documents\GitHub\ecommerce\backend\Models\review.js", "JavaScript", 10, 0, 0, 0, 4, 14
"c:\Users\Ljubo\Documents\GitHub\ecommerce\backend\Models\sale.js", "JavaScript", 14, 0, 0, 0, 4, 18
"c:\Users\Ljubo\Documents\GitHub\ecommerce\backend\Models\store.js", "JavaScript", 13, 0, 0, 0, 4, 17
"c:\Users\Ljubo\Documents\GitHub\ecommerce\backend\Models\user.js", "JavaScript", 25, 0, 0, 0, 4, 29
"c:\Users\Ljubo\Documents\GitHub\ecommerce\backend\Routes\auth.js", "JavaScript", 7, 0, 0, 0, 6, 13
"c:\Users\Ljubo\Documents\GitHub\ecommerce\backend\Routes\customer.js", "JavaScript", 39, 0, 0, 0, 4, 43
"c:\Users\Ljubo\Documents\GitHub\ecommerce\backend\Routes\store.js", "JavaScript", 49, 0, 0, 1, 23, 73
"c:\Users\Ljubo\Documents\GitHub\ecommerce\backend\Routes\user.js", "JavaScript", 15, 0, 0, 1, 9, 25
"c:\Users\Ljubo\Documents\GitHub\ecommerce\backend\index.js", "JavaScript", 34, 0, 0, 0, 5, 39
"c:\Users\Ljubo\Documents\GitHub\ecommerce\backend\package-lock.json", "JSON", 0, 6030, 0, 0, 1, 6031
"c:\Users\Ljubo\Documents\GitHub\ecommerce\backend\package.json", "JSON", 0, 24, 0, 0, 1, 25
"Total", "-", 924, 6054, 3, 39, 280, 7300